You awake in a dark room. You can feel yourself sitting in a chair and you can make out a table in front of you. You have no idea where you are or what you were last doing. In fact, you don't remember anything about your past.

Inform 7
An Interactive Fiction by Cameron Kuwada
Release 1 / Serial number 131020 / Inform 7 build 6G60 (I6/v6.32 lib 6/12N) SD

interrogation room
There is a bulletin board in the back. To the north is the hallway. A metal door to another room is to the east.

You can see Metal door and Shoes here.

I beg your pardon?

>n
You start running away as far as you can from the building. In no time will the place be swarming with guards. You don't have a plan for what to do next, all you can do is run away and piece everything together about your past. For now worry about finding shelter

    *** You have won ***

In that game you scored 0 out of a possible 0, in 1 turn.

Would you like to RESTART, RESTORE a saved game, QUIT or UNDO the last command?

* * *

You awake in a dark room. You can feel yourself sitting in a chair and you can make out a table in front of you. You have no idea where you are or what you were last doing. In fact, you don't remember anything about your past.

Inform 7
An Interactive Fiction by Cameron Kuwada
Release 1 / Serial number 131020 / Inform 7 build 6G60 (I6/v6.32 lib 6/12N) SD

interrogation room
There is a bulletin board in the back. To the north is the hallway. A metal door to another room is to the east.

You can see Metal door and Shoes here.

>x shoes
Elegant, black, leather shoes. They have laces.

>take all
Notice: Taken.
Thumbtack: Taken.
Shoes: Taken.

>x notice
There is a picture of a man with short grey hair and a five o'clock shadow. Above the picture, it says "Wanted: Jacob Smith."

>x metal door
You see nothing special about Metal door.

>open metal door
It seems to be locked.

>north
hallway
A guard paces back and forth through the hallway. To the north is the office.

You can see Officer here.

The guard sees you and shoots on sight.

    *** You have died ***

In that game you scored 0 out of a possible 0, in 6 turns.

Would you like to RESTART, RESTORE a saved game, QUIT or UNDO the last command?

>under
Please give one of the answers above.

Would you like to RESTART, RESTORE a saved game, QUIT or UNDO the last command?

>undo
interrogation room
[Previous turn undone.]

>west
You can't go that way.

>east
(first opening Metal door)
It seems to be locked.

>south
You can't go that way.

>unlock door
What do you want to unlock Metal door with?

>thumbtack
If you stick the thumbtack in it will get stuck, and you won't be able to pull it out.

>x bulletin board
Some sort of notice is pressed against board. A large thumbtack is pressed into the board as well.

>take thumbtack
You already have that.

>x bealt
You can't see any such thing.

>belt
That's not a verb I recognise.

>x belt
You can't see any such thing.

>combine shoes with thumbtack
You can't see any such thing.

>combine
You can't see any such thing.

>combine
You can't see any such thing.

>mix
That's not a verb I recognise.

>x shoes
Elegant, black, leather shoes. They have laces.

>unlock door with shoes
That doesn't seem to fit the lock.

>inventory
You are carrying:
  Shoes
  Thumbtack
  Notice

>unlock door
What do you want to unlock Metal door with?

>notice
That doesn't seem to fit the lock.

>put on shoes
Your feet ache really bad right now. One of the last things you want to do now is wear those uncomfortable things.

>east
(first opening Metal door)
It seems to be locked.

>x metal door
You see nothing special about Metal door.

>combine shoe laces
You can't see any such thing.

>x shoe laces
You can't see any such thing.

>x shoe
You can't see any such thing.

>x shoes
Elegant, black, leather shoes. They have laces.

>x thumbtack
A long, sharp red thumbtack.

>put thumbtack on shoes
Putting things on Shoes would achieve nothing.

>put shoes on thumbtack
Putting things on Thumbtack would achieve nothing.

>remove shoelaces
You remove shoelaces from shoes

>combine shoelaces with thumbtack
You thread the shoelace onto the thumbtack, making a lockpick.

>unlock metal door with lockpick
You unlock Metal door.

>east
(first opening Metal door)

surveillance room
This is where it seems someone was observing you while in the interrogation room. There is a computer here with a monitor for various rooms. In the corner of the room is a white cabinet. There is a closet against the wall.

You can see Metal door here.

>x closet
A large wooden closet. It looks pretty busted up.

>open closet
You open Closet, revealing Guard uniform and Pistol.

>take all
Guard uniform: Taken.
Pistol: Taken.

>west
interrogation room
It is very bright in here. There is a bulletin board in the back. in the corner are shoes and a belt. to the north is the hallway. A metal door to another room is to the east.

You can see Metal door here.

>north
hallway
A guard paces back and forth through the hallway. To the north is the office.

You can see Officer here.

The guard sees you and shoots on sight.

    *** You have died ***

In that game you scored 0 out of a possible 0, in 31 turns.

Would you like to RESTART, RESTORE a saved game, QUIT or UNDO the last command?

>undo
interrogation room
[Previous turn undone.]

>east
surveillance room
This is where it seems someone was observing you while in the interrogation room. There is a computer here with a monitor for various rooms. In the corner of the room is a white cabinet. There is a closet against the wall.

You can see Metal door here.

>open closet
That's already open.

>inventory
You are carrying:
  Pistol
  Guard uniform
  a lockpick
  Notice

>x computer
You see nothing special about Computer.

>west
interrogation room
It is very bright in here. There is a bulletin board in the back. in the corner are shoes and a belt. to the north is the hallway. A metal door to another room is to the east.

You can see Metal door here.

>east
surveillance room
This is where it seems someone was observing you while in the interrogation room. There is a computer here with a monitor for various rooms. In the corner of the room is a white cabinet. There is a closet against the wall.

You can see Metal door here.

>north
You can't go that way.

>south
You can't go that way.

>east
Lab
A large monitor hangs on the wall. There is keyboard that you can use.

You can see Keyboard here.

>take keyboard
Taken.

>use keyboard
That's not a verb I recognise.

>x keyboard
You see nothing special about Keyboard.

>x monitor
You can't see any such thing.

>east
You can't go that way.

>west
surveillance room
This is where it seems someone was observing you while in the interrogation room. There is a computer here with a monitor for various rooms. In the corner of the room is a white cabinet. There is a closet against the wall.

You can see Metal door here.

>north
You can't go that way.

>east
Lab
A large monitor hangs on the wall. There is keyboard that you can use.

>east
You can't go that way.

>north
You can't go that way.

* * *

>south
You can't go that way.

>inventory
You are carrying:
  Keyboard
  Pistol
  Guard uniform
  a lockpick
  Notice

>put on uniform
You put on Guard uniform.

>east
You can't go that way.

* * *

>north
You can't go that way.

>west
interrogation room
It is very bright in here. There is a bulletin board in the back. in the corner are shoes and a belt. to the north is the hallway. A metal door to another room is to the east.

You can see Metal door here.

>north
hallway
A guard paces back and forth through the hallway. To the north is the office.

You can see Officer here.

>shoot offier
I didn't understand that sentence.

>shoot officer
I didn't understand that sentence.

>talk to officer
That's not a verb I recognise.

>north
office
You can see White door here.

>open white door
It seems to be locked.

>x guard
You see nothing special about Guard uniform.

>x officer
You can't see any such thing.

>x Officer
You can't see any such thing.

>x Officer
You can't see any such thing.

>inventory
You are carrying:
  Keyboard
  Pistol
  Guard uniform (being worn)
  a lockpick
  Notice

>x player
You can't see any such thing.

* * *

You awake in a dark room. You can feel yourself sitting in a chair and you can make out a table in front of you. You have no idea where you are or what you were last doing. In fact, you don't remember anything about your past.

Inform 7
An Interactive Fiction by Cameron Kuwada
Release 1 / Serial number 131020 / Inform 7 build 6G60 (I6/v6.32 lib 6/12N) SD

interrogation room
There is a bulletin board in the back. To the north is the hallway. A metal door to another room is to the east.

You can see Metal door and Shoes here.

>take thumbtack
Taken.

>take shoes
Taken.

>remove shoelaces
You remove shoelaces from shoes

>x shoes
You can't see any such thing.

>combine shoelaces with thumbtack
You thread the shoelace onto the thumbtack, making a lockpick.

>x lockpick
A lockpick made with a shoelace and a thumbtack. True class right there.

>unlock door
You can't see any such thing.

>unlock backdoor with shoelaces
You can't see any such thing.

>unlock back door with lockpick
You can't see any such thing.

>unlock backdoor with lockpick
You unlock Backdoor.

>e
(first opening Backdoor)

surveillance room
This is where it seems someone was observing you while in the interrogation room. There is a surveillance system here. In the corner of the room is a white cabinet. There is a closet against the wall.

You can see Backdoor here.

>open closet
You open Closet, revealing Guard uniform and Pistol.

>take guard uniform
Taken.

>x closet
A large wooden closet. It looks pretty busted up.

In Closet is Pistol.

>wear guard uniform
You put on Guard uniform.

>wear uniform
You're already wearing that!

>wear guard uniform
You're already wearing that!

>w
interrogation room
It is very bright in here. There is a bulletin board in the back. in the corner are shoes and a belt. to the north is the hallway. A metal door to another room is to the east.

You can see Backdoor and Notice here.

>n
Hallway
A guard paces back and forth through the hallway. To the north is the office.

You can see Officer here.

>undo
interrogation room
[Previous turn undone.]

>wear guard uniform
You're already wearing that!

>b
That's not a verb I recognise.

>n
Hallway
A guard paces back and forth through the hallway. To the north is the office.

You can see Officer here.

* * *

>wear guard uniform
You're already wearing that!

>kill yourself
Violence isn't the answer to this one.

>die
That's not a verb I recognise.

* * *

You awake in a dark room. You can feel yourself sitting in a chair and you can make out a table in front of you. You have no idea where you are or what you were last doing. In fact, you don't remember anything about your past.

Inform 7
An Interactive Fiction by Cameron Kuwada
Release 1 / Serial number 131020 / Inform 7 build 6G60 (I6/v6.32 lib 6/12N) SD

interrogation room
There is a bulletin board in the back. To the north is the hallway. A metal door to another room is to the east.

You can see Metal door and Shoes here.

>x buletin board
You can't see any such thing.

>x bulletin board
A dull old bulletin board.

You see some sort of notice is pressed against board. There is a picture of a man with short grey hair and a shaggy beard. He has a scar above his right eye. Above the picture, it says "Wanted: Jacob Smith. Enemy to the United States. A large thumbtack is pressed into the board as well.
Well done!

[Your score has just gone up by one point.]

>take thumbtack
Taken.

>x bulletin board
A dull old bulletin board.

>x notice
There is a picture of a man with short grey hair and a shaggy beard. He has a scar above his right eye. Above the picture, it says "Wanted: Jacob Smith. Enemy to the United States."

>take shoes
Taken.

* * *

>remove shoelaces
You remove shoelaces from shoes

>combine shoelaces with thumbtack
You thread the shoelace onto the thumbtack, making a make shift lockpick.

>unlock door with thumbtack
You can't see any such thing.

>unlock door with lockpick
You unlock Metal door.

>e
(first opening Metal door)

surveillance room
In here, there is a surveillance system monitoring the room you were just in. In the corner of the room is a white cabinet. There is a closet against the wall.

You can see Metal door here.

>n
You can't go that way.

>open white cabinet
You open White Cabinet, revealing Files.

>take files
Taken.

>open closet
You open Closet, revealing Guard uniform.

>w
interrogation room
There is a bulletin board in the back. To the north is the hallway. A metal door to another room is to the east.

You can see Metal door and Notice here.

>n
You can hear a guard outside. Are you sure you want to go outside now, it looks like he's making sure you don't leave the area.

* * *

>wear guard uniform
You can't see any such thing.

>e
surveillance room
In here, there is a surveillance system monitoring the room you were just in. In the corner of the room is a white cabinet. There is a closet against the wall.

You can see Metal door here.

>open closet
That's already open.

>take guard uniform
As you take the guard uniform, you can see a mirror. You look at your face and see a giant scar above your right eye and your untrimmed five o" clock shadow. Wait a second You are Jacob Smith!!! You wonder what would possibly make you an enemy to the United States.e

>w
interrogation room
There is a bulletin board in the back. To the north is the hallway. A metal door to another room is to the east.

You can see Metal door and Notice here.

>wear guard uniform
You put on Guard uniform.

>n
You can hear a guard outside. Are you sure you want to go outside now, it looks like he's making sure you don't leave the area.

>yes
hallway
An officer paces around at the other end of the hallway. To the north is the office. to the west is a weapons room.

You can see White door and Officer here.

>talk to officer
I didn't understand that sentence.

>x officer
He wears a blue-collar shirt, and a red beret. His ID card rattles from a lanyard around his neck. He looks very tired right now. You should talk to him, maybe ask him about who you are.

>ask officer about jacob smith
The officer is asleep right now.

>n
office
The office is empty save for a secretary sitting at her table. To the west is a lab and to the east is the entrance. A black cabinet is in the back. There is a coffee machine on her table.

You can see Grey door, Secretary, Machine and Black cabinet (closed) here.

>ask secretary for coffee
"Yeah you can have some". The Secretary gives you coffee."

>e
(first opening Grey door)
It seems to be locked.

>w
Lab
In the middle of the room is a lab table. You notice a lines that make the shape of a large box in the wall. You also notice a line in the shape of a circle in the ground.

You can see Plutonic acid, Uranium juice and Nitrate chlorine here.

>take nitrate chlorine
Taken.

>x lab table
On the lab table are test tubes with the following labeled liquids: plutonic acid, uranium juice, and nitrate chlorine. There appears to be some thing under the table.

>press button
You press the button. Part of the wall slides away revealing a giant screen. A diagram comes up on the computer screen for you to examine. A circular part of the ground slides away, and a cylindrical glass shoots up from under the ground. It looks like there is person suspended inside.
Well done.

[Your score has just gone up by two points.]

>take nitrate chlorine
You already have that.

>take uranium juice
Taken.

>combine nitrate chlorine and unranium juice
You can't use multiple objects with that verb.

>combine nitrate chlorine and uranium juice
You can't use multiple objects with that verb.

* * *

>ask secretary for coffee
"Yeah you can have some". The Secretary gives you coffee."

>w
Lab
In the middle of the room is a lab table. You notice a lines that make the shape of a large box in the wall. You also notice a line in the shape of a circle in the ground.

You can see Plutonic acid, Uranium juice and Nitrate chlorine here.

>take uranium juice
Taken.

>take nitrate chlorine
Taken.

>combine uranium juice with nitrate chlorine
You mix the two to create the insta-sleep.

>e
office
The office is empty save for a secretary sitting at her table. To the west is a lab and to the east is the entrance. A black cabinet is in the back. There is a coffee machine on her table.

You can see Grey door, Secretary, Machine and Black cabinet (closed) here.

>combine coffee with insta-sleep
You drug the coffee.
well done
[Your score has just gone up by three points.]

>s
hallway
An officer paces around at the other end of the hallway. To the north is the office. to the west is a weapons room.

You can see White door and Officer here.

>give coffee to officer
You need to take his ID card from him. You need him to be asleep, not more alert.

* * *

>e
surveillance room
In here, there is a surveillance system monitoring the room you were just in. In the corner of the room is a white cabinet. There is a closet against the wall.

You can see Metal door here.

>take guard uniform
As you take the guard uniform, you can see a mirror. You look at your face and see a giant scar above your right eye and your untrimmed five o" clock shadow. Wait a second You are Jacob Smith!!! You wonder what would possibly make you an enemy to the United States.

>n
You can't go that way.

>w
interrogation room
There is a bulletin board in the back. To the north is the hallway. A metal door to another room is to the east.

You can see Metal door and Notice here.

* * *

>wear guard uniform
You put on Guard uniform.

* * *

>yes
hallway
An officer paces around at the other end of the hallway. To the north is the office. to the west is a weapons room.

You can see White door and Officer here.

>ask officer about jacob smith
He is asleep now, you cannot talk to him.

>n
office
The office is empty save for a secretary sitting at her table. To the west is a lab and to the east is the entrance. A black cabinet is in the back. There is a coffee machine on her table.

You can see Grey door, Secretary, Machine and Black cabinet (closed) here.

* * *

>w
Lab
In the middle of the room is a lab table. You notice a lines that make the shape of a large box in the wall. You also notice a line in the shape of a circle in the ground.

You can see Plutonic acid, Uranium juice and Nitrate chlorine here.

>take nitrate chorline
I only understood you as far as wanting to take Nitrate chlorine.

>take nitrate chlorine
Taken.

>take uranium juice
Taken.

>combine uranium juice with nitrate chlorine
You mix the two to create the insta-sleep.

* * *

>e
office
The office is empty save for a secretary sitting at her table. To the west is a lab and to the east is the entrance. A black cabinet is in the back. There is a coffee machine on her table.

You can see Grey door, Secretary, Machine and Black cabinet (closed) here.

>s
hallway
An officer paces around at the other end of the hallway. To the north is the office. to the west is a weapons room.

You can see White door and Officer here.

* * *

>give coffee to officer
You need to take his ID card from him. You need him to be asleep, not more alert.

>give drugged coffee to officer
You can't see any such thing.

>combine coffee with insta-sleep
You drug the coffee.
well done
[Your score has just gone up by three points.]

>give coffee to officer
You give the coffee to the officer. He takes a sip and then falls asleep. His ID falls onto the ground.
well done
[Your score has just gone up by three points.]

>w
(first opening White door)
It seems to be locked.

>unlock door with ID
(first taking the ID)
You unlock White door.

>w
(first opening White door)

weapons room
There is a gunshelf pinned against the wall. A metal case is in the back.

You can see White door and Metal case (closed) here.

>open metal case
You open Metal case, revealing Pistol.

>take pistol
Taken.

>e
hallway
To the north is the office. to the west is a weapons room.

You can see White door and Officer here.

>n
office
The office is empty save for a secretary sitting at her table. To the west is a lab and to the east is the entrance. A black cabinet is in the back. There is a coffee machine on her table.

You can see Grey door, Secretary, Machine and Black cabinet (closed) here.

>e
(first opening Grey door)
It seems to be locked.

>unlock grey door with ID
You unlock Grey door.

>e
(first opening Grey door)

entrance
The entrance room of this building. A metal detector stands here. To the east is an exit to the outside.

You can see Grey door and CIA agent here.

>ask CIA agent about jacob smith
He is dead now, you cannot talk to him.

>e
The CIA agent prevents you from doing so.

>kill CIA agent
Violence isn't the answer to this one.

>shoot CIA agent
You shoot the agent and he falls to the ground. You are know free to exit the building.

>x CIA agent
The agent lies dead on the ground. A man has to do what a man has to do.

>e
Alley
Buildings surround you in almost every direction. The only way to go is out north. There is a garbage can and a broken car.

>n
You start running away as far as you can from the building. In no time will the place be swarming with guards. You don't have a plan for what to do next, all you can do is run away and piece everything together about your past. For now worry about finding shelter

    *** You have won ***

In that game you scored 7 out of a possible 10, in 52 turns.

Would you like to RESTART, RESTORE a saved game, QUIT or UNDO the last command?

>undo
Alley
[Previous turn undone.]

>undo
entrance
[Previous turn undone.]

>undo
entrance
[Previous turn undone.]

>kill CIA agent
Violence isn't the answer to this one.

* * *

You awake in a dark room. You can feel yourself sitting in a chair and you can make out a table in front of you. You have no idea where you are or what you were last doing. In fact, you don't remember anything about your past.

Inform 7
An Interactive Fiction by Cameron Kuwada
Release 1 / Serial number 131020 / Inform 7 build 6G60 (I6/v6.32 lib 6/12N) SD

interrogation room
There is a bulletin board in the back. To the north is the hallway. A metal door to another room is to the east.

You can see Metal door and Shoes here.

>take all
Shoes: Taken.

>remove shoelaces
You remove shoelaces from shoes

* * *

I beg your pardon?

>combine shoelaces with thumbtack
You thread the shoelace onto the thumbtack, making a lockpick.

>unlock backdoor with lockpick
You unlock Backdoor.

* * *

>take guard uniform
Taken.

>wear shoes
You can't see any such thing.

>wear guard uniform
You put on Guard uniform.

>w
interrogation room
It is very bright in here. There is a bulletin board in the back. in the corner are shoes and a belt. to the north is the hallway. A metal door to another room is to the east.

You can see Backdoor here.

>n
Hallway
A guard paces back and forth through the hallway. To the north is the office.

You can see Officer here.

>talke to hallway
That's not a verb I recognise.

* * *

>take all
Shoes: Taken.

>remove shoelaces from shoes
You remove shoelaces from shoes

>x shoes
You can't see any such thing.

* * *

I beg your pardon?

>s
You can't go that way.

>combine shoelaces with thumbtack
You thread the shoelace onto the thumbtack, making a lockpick.

>use lockpick on door
That's not a verb I recognise.

>unlock door with lockpick
You can't see any such thing.

>unlock backdoor with lockpick
You unlock Backdoor.

* * *

>e
(first opening Backdoor)

surveillance room
This is where it seems someone was observing you while in the interrogation room. There is a surveillance system here. In the corner of the room is a white cabinet. There is a closet against the wall.

You can see Backdoor here.

>take all
There are none at all available!

>open closet
You open Closet, revealing Guard uniform and Pistol.

* * *

>take guard uniform
Taken.

>w
interrogation room
It is very bright in here. There is a bulletin board in the back. in the corner are shoes and a belt. to the north is the hallway. A metal door to another room is to the east.

You can see Backdoor here.

>n
Hallway
A guard paces back and forth through the hallway. To the north is the office.

You can see Officer here.

The guard sees you and shoots on sight.

    *** You have died ***

In that game you scored 0 out of a possible 0, in 12 turns.

Would you like to RESTART, RESTORE a saved game, QUIT or UNDO the last command?

>undo
interrogation room
[Previous turn undone.]

>wear guard uniform
You put on Guard uniform.

>n
Hallway
A guard paces back and forth through the hallway. To the north is the office.

You can see Officer here.

* * *

>take all
Shoes: Taken.

>undo
interrogation room
[Previous turn undone.]

* * *

>take all
Shoes: Taken.

>remove shoes
You're not wearing that.

>remove shoelaces
You remove shoelaces from shoes

>combine shoelaces with thumbtack
You can't see any such thing.

>x bulletin board
Some sort of notice is pressed against board. A large thumbtack is pressed into the board as well.

>take thumbtack
Taken.

>combine shoelaces with thumbtack
You thread the shoelace onto the thumbtack, making a make shift lockpick.

>unlock door with lockpick
You unlock Metal door.

>e
(first opening Metal door)

surveillance room
This is where it seems someone was observing you while in the interrogation room. There is a surveillance system monitoring various rooms. In the corner of the room is a white cabinet. There is a closet against the wall. To the west is lab.

You can see Metal door here.

>open closet
You open Closet, revealing Guard uniform and Pistol.

>take guard uniform
As you take the guard uniform, you can see a mirror. You look at your face and see a giant scar above your right eye and your untrimmed five o" clock shadow. Wait a second You are Jacob Smith!!!

* * *

You awake in a dark room. You can feel yourself sitting in a chair and you can make out a table in front of you. You have no idea where you are or what you were last doing. In fact, you don't remember anything about your past.

Inform 7
An Interactive Fiction by Cameron Kuwada
Release 1 / Serial number 131020 / Inform 7 build 6G60 (I6/v6.32 lib 6/12N) SD

interrogation room
There is a bulletin board in the back. To the north is the hallway. A metal door to another room is to the east.

You can see Metal door and Shoes here.

>take shoes
Taken.

>x bulletin board
Some sort of notice is pressed against board. A large thumbtack is pressed into the board as well.

* * *

>take thumbtack
Taken.

>take shoes
You already have that.

>remove shoelaces
You remove shoelaces from shoes

>combine thumbtack with shoelaces
You thread the shoelace onto the thumbtack, making a make shift lockpick.

>unlock door with lockpick
You unlock Metal door.

* * *

>e
(first opening Metal door)

surveillance room
In here, there is a surveillance system monitoring the room you were just in. In the corner of the room is a white cabinet. There is a closet against the wall.

You can see Metal door here.

>open closet
You open Closet, revealing Guard uniform.

>take guard uniform
As you take the guard uniform, you can see a mirror. You look at your face and see a giant scar above your right eye and your untrimmed five o" clock shadow. Wait a second You are Jacob Smith!!!

>x me
There are sweat stains on your shirt. Your army pants have dirt stains. There are a couple of bruises on your arms. You have a shaggy grey beard and a scar above your right eye. Apparently you are the infamous Jacob Smith.

>open cabinet
You open White Cabinet, revealing Files.

>take files
Taken.

>x files
A bunch of files. None are important except for one on in a red piece folder that says "Profile: Jacob Smith. Property of U.S. military."

I beg your pardon?

I beg your pardon?

>w
interrogation room
There is a bulletin board in the back. To the north is the hallway. A metal door to another room is to the east.

You can see Metal door and Notice here.

* * *

>n
You can hear a guard outside. Are you sure you want to go outside now, it looks like he's making sure you don't leave the area.

>wear guard uniform
Please answer yes or no.

* * *

>wear guard uniform
You put on Guard uniform.

>yes
That was a rhetorical question.

>n
You can hear a guard outside. Are you sure you want to go outside now, it looks like he's making sure you don't leave the area.

* * *

>yes
hallway
An officer paces around at the other end of the hallway. To the north is the office. to the west is a weapons room.

You can see White door and Officer here.

>w
(first opening White door)
It seems to be locked.

>talk to officer
That's not a verb I recognise.

>n
office
The office is empty save for a secretary sitting at her table. To the west is a lab and to the east is the entrance. A black cabinet is in the back. There is a coffee machine on her table.

You can see Grey door, Secretary, Machine and Black cabinet (closed) here.

* * *

>ask secretary for coffee
"Yeah you can have some". The Secretary gives you coffee."

>open cabinet
You open Black cabinet, revealing Chemical recipes.

>take recipe
You can't see any such thing.

>x chemical recipes
Formula for insta-sleep: nitrate chlorine and uranium juice.

>w
Lab
In the middle of the room is a lab table. You notice a lines that make the shape of a large box in the wall. You also notice a line in the shape of a circle in the ground.

You can see Plutonic acid, Uranium juice and Nitrate chlorine here.

>take uranium juice and nitrate chlorine
Uranium juice: Taken.
Nitrate chlorine: Taken.

>cobine uranium juice and nitrate chlorine
That's not a verb I recognise.

>combine uranium juice with nitrate chlorine
You mix the two to create the insta-sleep.

>combine coffee with insta-sleep
You drug the coffee.

>x coffee
It is bubbling and hot and has little specks of powder inside.

>e
office
The office is empty save for a secretary sitting at her table. To the west is a lab and to the east is the entrance. A black cabinet is in the back. There is a coffee machine on her table.

You can see Grey door, Secretary, Machine and Black cabinet (in which is Chemical recipes) here.

>s
hallway
An officer paces around at the other end of the hallway. To the north is the office. to the west is a weapons room.

You can see White door and Officer here.

>give officer drugged coffee
You can't see any such thing.

>give officer coffee
You give the coffee to the officer. He takes a sip and then falls asleep. His ID falls onto the ground.

>x officer
He's fast asleep right now.

He wears a blue-collar shirt, and a red beret. His ID card rattles from a lanyard around his neck. He looks very tired right now. You should ask him about who you are.

>take ID
Taken.

>x door
A high-tech door with a card swiper that requires an ID to open it.

>open door
It seems to be locked.

>unlock door with ID
You unlock White door.

>w
(first opening White door)

weapons room
There is a gunshelf pinned against the wall. A metal case is in the back.

You can see White door and Metal case (closed) here.

* * *

>e
hallway
An officer paces around at the other end of the hallway. To the north is the office. to the west is a weapons room.

You can see White door and Officer here.

>n
office
The office is empty save for a secretary sitting at her table. To the west is a lab and to the east is the entrance. A black cabinet is in the back. There is a coffee machine on her table.

You can see Grey door, Secretary, Machine and Black cabinet (in which is Chemical recipes) here.

>e
(first opening Grey door)
It seems to be locked.

* * *

>e
(first opening Grey door)

entrance
The entrance room of this building. A metal detector stands here. To the east is an exit to the outside.

You can see Grey door and CIA agent here.

>go to entrance
You can't see any such thing.

>ask CIA agent about r
"Silence" he says.

>shoot CIA agent
If only you had some weapon to shoot the agent with.

* * *

You awake in a dark room. You can feel yourself sitting in a chair and you can make out a table in front of you. You have no idea where you are or what you were last doing. In fact, you don't remember anything about your past.

Inform 7
An Interactive Fiction by Cameron Kuwada
Release 1 / Serial number 131020 / Inform 7 build 6G60 (I6/v6.32 lib 6/12N) SD

interrogation room
There is a bulletin board in the back. To the north is the hallway. A metal door to another room is to the east.

You can see Metal door and Shoes here.

>x bulletin board
A dull old bulletin board.

You see some sort of notice is pressed against board. There is a picture of a man with short grey hair and a shaggy beard. He has a scar above his right eye. Above the picture, it says "Wanted: Jacob Smith. Enemy to the United States. A large thumbtack is pressed into the board as well.

[Your score has just gone up by one point.]

>take thumbtack
Taken.

* * *

>open closet
You open Closet, revealing Guard uniform.

>take guard uniform
As you take the guard uniform, you can see a mirror. You look at your face and see a giant scar above your right eye and your untrimmed five o" clock shadow. Wait a second You are Jacob Smith!!! You wonder what would possibly make you an enemy to the United States.

>w
interrogation room
There is a bulletin board in the back. To the north is the hallway. A metal door to another room is to the east.

You can see Metal door and Notice here.

* * *

>yes
hallway
An officer paces around at the other end of the hallway. To the north is the office. to the west is a weapons room.

You can see White door and Officer here.

>n
office
The office is empty save for a secretary sitting at her table. To the west is a lab and to the east is the entrance. A black cabinet is in the back. There is a coffee machine on her table.

You can see Grey door, Secretary, Machine and Black cabinet (closed) here.

* * *

>ask secretary for coffee
"Yeah you can have some". The Secretary gives you coffee."

>w
Lab
In the middle of the room is a lab table. You notice a lines that make the shape of a large box in the wall. You also notice a line in the shape of a circle in the ground.

>take nitrate chlorine
Taken.

>take plutonic acid
Taken.

>combine nitrate chlorine with plutonic acid
You can't see any such thing.

>take uranium juice
Taken.

* * *

>combine uranium juice with nitrate chlorine
You mix the two to create the insta-sleep.

>combine insta-sleep with coffee
You drug the coffee.
well done
[Your score has just gone up by three points.]

>x table
On the lab table are test tubes with the following labeled liquids: plutonic acid, uranium juice, and nitrate chlorine. There appears to be some thing under the table.

>press switch
You can't see any such thing.

>press button
You press the button. Part of the wall slides away revealing a giant screen. A diagram comes up on the computer screen for you to examine. A circular part of the ground slides away, and a cylindrical glass shoots up from under the ground. It looks like there is person suspended inside.
Well done.

[Your score has just gone up by two points.]

>look under table
You see a blue button underneath the table.

>e
office
The office is empty save for a secretary sitting at her table. To the west is a lab and to the east is the entrance. A black cabinet is in the back. There is a coffee machine on her table.

You can see Grey door, Secretary, Machine and Black cabinet (closed) here.

* * *

>s
hallway
An officer paces around at the other end of the hallway. To the north is the office. to the west is a weapons room.

You can see White door and Officer here.

>ask officer about jacob smith
"Jacob Smith Is a dangerous man. We captured him and have him in questioning in the interrogation room back there

>officer
Who do you mean, Officer or DEADOFFICER?

>Officer
Who do you mean, Officer or DEADOFFICER?

* * *

>ask officer about jacob smith
"Jacob Smith Is a dangerous man. We captured him and have him in questioning in the interrogation room back there

>give coffee to officer
You give the coffee to the officer. He takes a sip and then falls asleep. His ID falls onto the ground.
well done
[Your score has just gone up by three points.]

>take ID
Taken.

>w
(first opening White door)
It seems to be locked.

>unlock door with ID
You unlock White door.

* * *

>w
(first opening White door)

weapons room
There is a gunshelf pinned against the wall. A metal case is in the back.

You can see White door and Metal case (closed) here.

>take pistol
You can't see any such thing.

>open case
You open Metal case, revealing Pistol.

>take pistol
Taken.

>e
hallway
To the north is the office. to the west is a weapons room.

You can see White door and DEADOFFICER here.

>n
office
The office is empty save for a secretary sitting at her table. To the west is a lab and to the east is the entrance. A black cabinet is in the back. There is a coffee machine on her table.

You can see Grey door, Secretary, Machine and Black cabinet (closed) here.

>unlock door with ID
You unlock Grey door.

>e
(first opening Grey door)

entrance
The entrance room of this building. A metal detector stands here. To the east is an exit to the outside.

You can see Grey door and CIA agent here.

A CIA agent stands with his gun pointed to you. "I have been watching you trying to escape Mr. Smith. You are one dangerous man. But here is where it ends. Stay where you are." He said. He stands preventing you from escaping. You have to resort to voilence.

>shoot guard
I didn't understand that sentence.

>shoot guard
I didn't understand that sentence.

>kill guard
Violence isn't the answer to this one.

A CIA agent stands with his gun pointed to you. "I have been watching you trying to escape Mr. Smith. You are one dangerous man. But here is where it ends. Stay where you are." He said. He stands preventing you from escaping. You have to resort to voilence.

>kill guard with pistol
I only understood you as far as wanting to kill Guard uniform.

>shoot CIA agent
You shoot the agent and he falls to the ground. You are know free to exit the building.

A CIA agent stands with his gun pointed to you. "I have been watching you trying to escape Mr. Smith. You are one dangerous man. But here is where it ends. Stay where you are." He said. He stands preventing you from escaping. You have to resort to voilence.

>x CIA agent
The agent lies dead on the ground. A man has to do what a man has to do.

A CIA agent stands with his gun pointed to you. "I have been watching you trying to escape Mr. Smith. You are one dangerous man. But here is where it ends. Stay where you are." He said. He stands preventing you from escaping. You have to resort to voilence.

>e
Alley
Buildings surround you in almost every direction. The only way to go is out north. There is a garbage can and a broken car.

>n
You start running away as far as you can from the building. In no time will the place be swarming with guards. You don't have a plan for what to do next, all you can do is run away and piece everything together about your past. For now worry about finding shelter.

    *** You have won ***

In that game you scored 9 out of a possible 13, in 43 turns.

Would you like to RESTART, RESTORE a saved game, QUIT or UNDO the last command?

* * *

>w
Lab
In the middle of the room is a lab table. You notice a lines that make the shape of a large box in the wall. You also notice a line in the shape of a circle in the ground.

>x lab table
A nice lab table. There appears to be some thing under the table.

Three test tubes are on the lab table. Plutonic acid, uranium juice, and nitrate chlorine.

>take uranium juice
Taken.

* * *

You awake in a dark room. You can feel yourself sitting in a chair and you can make out a table in front of you. You have no idea where you are or what you were last doing. In fact, you don't remember anything about your past.

Inform 7
An Interactive Fiction by Cameron Kuwada
Release 1 / Serial number 131020 / Inform 7 build 6G60 (I6/v6.32 lib 6/12N) SD

interrogation room
There is a bulletin board in the back. To the north is the hallway. A metal door to another room is to the east.

You can see Metal door and Shoes here.

>x metal door
You can't see any such thing.

>x backdoor
You see nothing special about Backdoor.

>x notice
There is a picture of a man with short grey hair and a five o'clock shadow. Above the picture, it says "Wanted: Jacob Smith."

>x mna
You can't see any such thing.

>x man
You can't see any such thing.

>x shoes
Elegant, black, leather shoes. They have laces.

>x laces
You can't see any such thing.

>x thumbtack
A long, sharp red thumbtack.

>take all
Notice: Taken.
Thumbtack: Taken.
Shoes: Taken.

>e
(first opening Backdoor)
It seems to be locked.

>w
You can't go that way.

>s
You can't go that way.

>n
Hallway
A guard paces back and forth through the hallway. To the north is the office.

You can see Officer here.

The guard sees you and shoots on sight.

    *** You have died ***

In that game you scored 0 out of a possible 0, in 9 turns.

Would you like to RESTART, RESTORE a saved game, QUIT or UNDO the last command?

>undo
interrogation room
[Previous turn undone.]

>l
interrogation room
It is very bright in here. There is a bulletin board in the back. in the corner are shoes and a belt. to the north is the hallway. A metal door to another room is to the east.

You can see Backdoor here.

>take backdoor
That's fixed in place.

>x bulletin board
Some sort of notice is pressed against board. A large thumbtack is pressed into the board as well.

>take belt
You can't see any such thing.

>turn off light
You can't see any such thing.

>x light
You can't see any such thing.

>x switch
You can't see any such thing.

>i
You are carrying:
  Shoes
  Thumbtack
  Notice

>put on shoes
Your feet ache really bad right now. One of the last things you want to do now is wear those uncomfortable things.

>read notice
There is a picture of a man with short grey hair and a five o'clock shadow. Above the picture, it says "Wanted: Jacob Smith."

>x me
As good-looking as ever.

>s
You can't go that way.

>w
You can't go that way.

>up
You can't go that way.

>down
You can't go that way.

>e
(first opening Backdoor)
It seems to be locked.

>open backdoor
It seems to be locked.

>unlock backdoor
What do you want to unlock Backdoor with?

>thumbtack
That doesn't seem to fit the lock.

>unlock backdoor with shoes
That doesn't seem to fit the lock.

>unlock backdoor with notice
That doesn't seem to fit the lock.

>i
You are carrying:
  Shoes
  Thumbtack
  Notice

>l
interrogation room
It is very bright in here. There is a bulletin board in the back. in the corner are shoes and a belt. to the north is the hallway. A metal door to another room is to the east.

You can see Backdoor here.

>x shoes
Elegant, black, leather shoes. They have laces.

>take laces
You can't see any such thing.

>x door
You can't see any such thing.

>x metal door
You can't see any such thing.

>n
Hallway
A guard paces back and forth through the hallway. To the north is the office.

You can see Officer here.

The guard sees you and shoots on sight.

    *** You have died ***

In that game you scored 0 out of a possible 0, in 28 turns.

Would you like to RESTART, RESTORE a saved game, QUIT or UNDO the last command?

>undo
interrogation room
[Previous turn undone.]

>e
(first opening Backdoor)
It seems to be locked.

>n
Hallway
A guard paces back and forth through the hallway. To the north is the office.

You can see Officer here.

The guard sees you and shoots on sight.

    *** You have died ***

In that game you scored 0 out of a possible 0, in 29 turns.

Would you like to RESTART, RESTORE a saved game, QUIT or UNDO the last command?

>undo
interrogation room
[Previous turn undone.]

* * *

>l
interrogation room
It is very bright in here. There is a bulletin board in the back. in the corner are shoes and a belt. to the north is the hallway. A metal door to another room is to the east.

You can see Backdoor here.

>x light
You can't see any such thing.

>x bright
You can't see any such thing.

>throw thumbtack
Dropped.

>take thumbtack
Taken.

>cover light
You can't see any such thing.

>take notics
You can't see any such thing.

>put notice on light
You can't see any such thing.

>unlock door
You can't see any such thing.

>unlock backdoor
What do you want to unlock Backdoor with?

* * *

>thumbtack
That doesn't seem to fit the lock.

>x backdoor
You see nothing special about Backdoor.

>x metal door
You can't see any such thing.

>x me
As good-looking as ever.

>x thumbtack
A long, sharp red thumbtack.

>attack door
You can't see any such thing.

>attack backdoor
Violence isn't the answer to this one.

>attack me
Violence isn't the answer to this one.

>stab door
That's not a verb I recognise.

>w
You can't go that way.

* * *

>s
You can't go that way.

>e
(first opening Backdoor)
It seems to be locked.

>put thumbtack on light
You can't see any such thing.

>kick door
That's not a verb I recognise.

>push door
You can't see any such thing.

>attack door
You can't see any such thing.

>jump
You jump on the spot, fruitlessly.

>sleep
You aren't feeling especially drowsy.

>i
You are carrying:
  Thumbtack
  Shoes
  Notice

>l
interrogation room
It is very bright in here. There is a bulletin board in the back. in the corner are shoes and a belt. to the north is the hallway. A metal door to another room is to the east.

You can see Backdoor here.

>x bulletin door
I only understood you as far as wanting to examine Bulletin board.

>x bulletin
Some sort of notice is pressed against board. A large thumbtack is pressed into the board as well.

>x board
Some sort of notice is pressed against board. A large thumbtack is pressed into the board as well.

>x notice
There is a picture of a man with short grey hair and a five o'clock shadow. Above the picture, it says "Wanted: Jacob Smith."

>x picture
You can't see any such thing.

>x me
As good-looking as ever.

>n
Hallway
A guard paces back and forth through the hallway. To the north is the office.

You can see Officer here.

The guard sees you and shoots on sight.

    *** You have died ***

In that game you scored 0 out of a possible 0, in 49 turns.

Would you like to RESTART, RESTORE a saved game, QUIT or UNDO the last command?

>s
Please give one of the answers above.

Would you like to RESTART, RESTORE a saved game, QUIT or UNDO the last command?

>undo
interrogation room
[Previous turn undone.]

>x hallway
You can't see any such thing.

>x officer
You can't see any such thing.

>throw thumbtack into hallway
You can't see any such thing.

>throw thumbtack at guard
You can't see any such thing.

>l
interrogation room
It is very bright in here. There is a bulletin board in the back. in the corner are shoes and a belt. to the north is the hallway. A metal door to another room is to the east.

You can see Backdoor here.

* * *

>x light
You can't see any such thing.

>x up
You see nothing unexpected in that direction.

>x wall
You can't see any such thing.

>x ceiling
You can't see any such thing.

>x floor
You can't see any such thing.

>remove shoelaces
You remove shoelaces from shoes

>combine thumbtack
(with Shoelaces)

* * *

>combine shoelaves with thumbtack
You can't see any such thing.

>unlock door with lockpick
You can't see any such thing.

>combine shoelaces with thumbtack
You thread the shoelace onto the thumbtack, making a lockpick.

>unlock backdoor with thumbtack
You can't see any such thing.

>unlock back door with lockpick
You can't see any such thing.

>i
You are carrying:
  a lockpick
  Notice

>unlock backdoor with lockpick
You unlock Backdoor.

* * *

>e
(first opening Backdoor)

surveillance room
This is where it seems someone was observing you while in the interrogation room. There is a surveillance system here. In the corner of the room is a white cabinet. There is a closet against the wall.

You can see Backdoor here.

>x surveillance system
You can't see any such thing.

>x white cabinet
A white cabinet. There's probably files inside.

>open cabinet
You open White Cabinet, revealing Files.

>take cabinet
That's hardly portable.

>take files
Taken.

>x closet
A large wooden closet. It looks pretty busted up.

>x wall
You can't see any such thing.

>take closet
That's hardly portable.

>open closet
You open Closet, revealing Guard uniform and Pistol.

* * *

>take all
Guard uniform: Taken.
Pistol: Taken.

>put on uniform
You put on Guard uniform.

>put on pistol
You can't wear that!

>w
interrogation room
It is very bright in here. There is a bulletin board in the back. in the corner are shoes and a belt. to the north is the hallway. A metal door to another room is to the east.

You can see Backdoor here.

* * *

>n
Hallway
A guard paces back and forth through the hallway. To the north is the office.

You can see Officer here.

>attack officer
Violence isn't the answer to this one.

>shoot officer
That's not a verb I recognise.