You awake in a dark room. You can't see anything at all. You can feel yourself sitting in a chair and you can make out a table in front of you. You have no idea where you are or what you were last doing. In fact, you don't remember anything about your past.

Inform 7
An Interactive Fiction by Cameron Kuwada
Release 1 / Serial number 131007 / Inform 7 build 6G60 (I6/v6.32 lib 6/12N) SD

interrogation room
It is very bright in here. There is a bulletin board in the back. in the corner are shoes and a belt.

You can see Backdoor, Notice, Thumbtack and Shoes here.

>take shoes
Taken.

* * *

>remove shoelaces from shoes
You can't see any such thing.

>take shoelaces
You already have that.

* * *

>remove shoelaces from shoes
You can't see any such thing.

>take all
Notice: Taken.
Thumbtack: Taken.

* * *

You awake in a dark room. You can't see anything at all. You can feel yourself sitting in a chair and you can make out a table in front of you. You have no idea where you are or what you were last doing. In fact, you don't remember anything about your past.

Inform 7
An Interactive Fiction by Cameron Kuwada
Release 1 / Serial number 131007 / Inform 7 build 6G60 (I6/v6.32 lib 6/12N) SD

interrogation room
It is very bright in here. There is a bulletin board in the back. in the corner are shoes and a belt.

You can see Backdoor, Notice, Thumbtack and Shoes here.

>take thumbtack
Taken.

* * *

>unlock backdoor with lockpick
You unlock Backdoor.

>e
(first opening Backdoor)

surveillance room
A metal case lies against the wall. A gun shelf is bolted against another wall. To the south is the office.

You can see Backdoor here.

>s
You can't go that way.