You awake in a dark room. You can't see anything at all. You can feel yourself sitting in a chair and you can make out a table in front of you. You have no idea where you are or what you were last doing. In fact, you don't remember anything about your past.

Inform 7
An Interactive Fiction by Cameron Kuwada
Release 1 / Serial number 131017 / Inform 7 build 6G60 (I6/v6.32 lib 6/12N) SD

interrogation room
It is very   in here. There is a bulletin board in the back. To the north is the hallway. A metal door to another room is to the east.

You can see Metal door and Shoes here.

>x shoes
Elegant, black, leather shoes. They have laces.

>take all
Notice: Taken.
Thumbtack: Taken.
Shoes: Taken.

>x notice
There is a picture of a man with short grey hair and a five o'clock shadow. Above the picture, it says "Wanted: Jacob Smith."

>x metal door
You see nothing special about Metal door.

>open metal door
It seems to be locked.

>north
hallway
A guard paces back and forth through the hallway. To the north is the office.

You can see Officer here.

The guard sees you and shoots on sight.

    *** You have died ***

In that game you scored 0 out of a possible 0, in 6 turns.

Would you like to RESTART, RESTORE a saved game, QUIT or UNDO the last command?

>under
Please give one of the answers above.

Would you like to RESTART, RESTORE a saved game, QUIT or UNDO the last command?

>undo
interrogation room
[Previous turn undone.]

>west
You can't go that way.

>east
(first opening Metal door)
It seems to be locked.

>south
You can't go that way.

>unlock door
What do you want to unlock Metal door with?

>thumbtack
If you stick the thumbtack in it will get stuck, and you won't be able to pull it out.

>x bulletin board
Some sort of notice is pressed against board. A large thumbtack is pressed into the board as well.

>take thumbtack
You already have that.

>x bealt
You can't see any such thing.

>belt
That's not a verb I recognise.

>x belt
You can't see any such thing.

>combine shoes with thumbtack
You can't see any such thing.

>combine
You can't see any such thing.

>combine
You can't see any such thing.

>mix
That's not a verb I recognise.

>x shoes
Elegant, black, leather shoes. They have laces.

>unlock door with shoes
That doesn't seem to fit the lock.

>inventory
You are carrying:
  Shoes
  Thumbtack
  Notice

>unlock door
What do you want to unlock Metal door with?

>notice
That doesn't seem to fit the lock.

>put on shoes
Your feet ache really bad right now. One of the last things you want to do now is wear those uncomfortable things.

>east
(first opening Metal door)
It seems to be locked.

>x metal door
You see nothing special about Metal door.

>combine shoe laces
You can't see any such thing.

>x shoe laces
You can't see any such thing.

>x shoe
You can't see any such thing.

>x shoes
Elegant, black, leather shoes. They have laces.

>x thumbtack
A long, sharp red thumbtack.

>put thumbtack on shoes
Putting things on Shoes would achieve nothing.

>put shoes on thumbtack
Putting things on Thumbtack would achieve nothing.

>remove shoelaces
You remove shoelaces from shoes

>combine shoelaces with thumbtack
You thread the shoelace onto the thumbtack, making a lockpick.

>unlock metal door with lockpick
You unlock Metal door.

>east
(first opening Metal door)

surveillance room
This is where it seems someone was observing you while in the interrogation room. There is a computer here with a monitor for various rooms. In the corner of the room is a white cabinet. There is a closet against the wall.

You can see Metal door here.

>x closet
A large wooden closet. It looks pretty busted up.

>open closet
You open Closet, revealing Guard uniform and Pistol.

>take all
Guard uniform: Taken.
Pistol: Taken.

>west
interrogation room
It is very bright in here. There is a bulletin board in the back. in the corner are shoes and a belt. to the north is the hallway. A metal door to another room is to the east.

You can see Metal door here.

>north
hallway
A guard paces back and forth through the hallway. To the north is the office.

You can see Officer here.

The guard sees you and shoots on sight.

    *** You have died ***

In that game you scored 0 out of a possible 0, in 31 turns.

Would you like to RESTART, RESTORE a saved game, QUIT or UNDO the last command?

>undo
interrogation room
[Previous turn undone.]

>east
surveillance room
This is where it seems someone was observing you while in the interrogation room. There is a computer here with a monitor for various rooms. In the corner of the room is a white cabinet. There is a closet against the wall.

You can see Metal door here.

>open closet
That's already open.

>inventory
You are carrying:
  Pistol
  Guard uniform
  a lockpick
  Notice

>x computer
You see nothing special about Computer.

>west
interrogation room
It is very bright in here. There is a bulletin board in the back. in the corner are shoes and a belt. to the north is the hallway. A metal door to another room is to the east.

You can see Metal door here.

>east
surveillance room
This is where it seems someone was observing you while in the interrogation room. There is a computer here with a monitor for various rooms. In the corner of the room is a white cabinet. There is a closet against the wall.

You can see Metal door here.

>north
You can't go that way.

>south
You can't go that way.

>east
Lab
A large monitor hangs on the wall. There is keyboard that you can use.

You can see Keyboard here.

>take keyboard
Taken.

>use keyboard
That's not a verb I recognise.

>x keyboard
You see nothing special about Keyboard.

>x monitor
You can't see any such thing.

>east
You can't go that way.

>west
surveillance room
This is where it seems someone was observing you while in the interrogation room. There is a computer here with a monitor for various rooms. In the corner of the room is a white cabinet. There is a closet against the wall.

You can see Metal door here.

>north
You can't go that way.

>east
Lab
A large monitor hangs on the wall. There is keyboard that you can use.

>east
You can't go that way.

>north
You can't go that way.

* * *

>south
You can't go that way.

>inventory
You are carrying:
  Keyboard
  Pistol
  Guard uniform
  a lockpick
  Notice

>put on uniform
You put on Guard uniform.

>east
You can't go that way.

* * *

>north
You can't go that way.

>west
interrogation room
It is very bright in here. There is a bulletin board in the back. in the corner are shoes and a belt. to the north is the hallway. A metal door to another room is to the east.

You can see Metal door here.

>north
hallway
A guard paces back and forth through the hallway. To the north is the office.

You can see Officer here.

>shoot offier
I didn't understand that sentence.

>shoot officer
I didn't understand that sentence.

>talk to officer
That's not a verb I recognise.

>north
office
You can see White door here.

>open white door
It seems to be locked.

>x guard
You see nothing special about Guard uniform.

>x officer
You can't see any such thing.

>x Officer
You can't see any such thing.

>x Officer
You can't see any such thing.

>inventory
You are carrying:
  Keyboard
  Pistol
  Guard uniform (being worn)
  a lockpick
  Notice

>x player
You can't see any such thing.

* * *

You awake in a dark room. You can't see anything at all. You can feel yourself sitting in a chair and you can make out a table in front of you. You have no idea where you are or what you were last doing. In fact, you don't remember anything about your past.

Inform 7
An Interactive Fiction by Cameron Kuwada
Release 1 / Serial number 131017 / Inform 7 build 6G60 (I6/v6.32 lib 6/12N) SD

interrogation room
It is very   in here. There is a bulletin board in the back. To the north is the hallway. A metal door to another room is to the east.

You can see Metal door and Shoes here.

>take thumbtack
Taken.

>take shoes
Taken.

>remove shoelaces
You remove shoelaces from shoes

>x shoes
You can't see any such thing.

>combine shoelaces with thumbtack
You thread the shoelace onto the thumbtack, making a lockpick.

>x lockpick
A lockpick made with a shoelace and a thumbtack. True class right there.

>unlock door
You can't see any such thing.

>unlock backdoor with shoelaces
You can't see any such thing.

>unlock back door with lockpick
You can't see any such thing.

>unlock backdoor with lockpick
You unlock Backdoor.

>e
(first opening Backdoor)

surveillance room
This is where it seems someone was observing you while in the interrogation room. There is a surveillance system here. In the corner of the room is a white cabinet. There is a closet against the wall.

You can see Backdoor here.

>s
You can't go that way.

* * *

>e
(first opening Backdoor)

surveillance room
This is where it seems someone was observing you while in the interrogation room. There is a surveillance system here. In the corner of the room is a white cabinet. There is a closet against the wall.

You can see Backdoor here.

>open closet
You open Closet, revealing Guard uniform and Pistol.

>take guard uniform
Taken.

>w
interrogation room
It is very bright in here. There is a bulletin board in the back. in the corner are shoes and a belt. to the north is the hallway. A metal door to another room is to the east.

You can see Backdoor and Notice here.

>n
Hallway
A guard paces back and forth through the hallway. To the north is the office.

You can see Officer here.

The guard sees you and shoots on sight.

    *** You have died ***

In that game you scored 0 out of a possible 0, in 11 turns.

Would you like to RESTART, RESTORE a saved game, QUIT or UNDO the last command?

>undo
interrogation room
[Previous turn undone.]

>wear guard uniform
You put on Guard uniform.

>n
take thumbtack

* * *

>take guard uniform
Taken.

>x closet
A large wooden closet. It looks pretty busted up.

In Closet is Pistol.

>wear guard uniform
You put on Guard uniform.

>wear uniform
You're already wearing that!

>wear guard uniform
You're already wearing that!

>w
interrogation room
It is very bright in here. There is a bulletin board in the back. in the corner are shoes and a belt. to the north is the hallway. A metal door to another room is to the east.

You can see Backdoor and Notice here.

>n
Hallway
A guard paces back and forth through the hallway. To the north is the office.

You can see Officer here.

>undo
interrogation room
[Previous turn undone.]

>wear guard uniform
You're already wearing that!

>j
That's not a verb I recognise.

>n
Hallway
A guard paces back and forth through the hallway. To the north is the office.

You can see Officer here.

    *** You have died ***

In that game you scored 0 out of a possible 0, in 16 turns.

Would you like to RESTART, RESTORE a saved game, QUIT or UNDO the last command?

* * *

>wear guard uniform
You're already wearing that!

>b
That's not a verb I recognise.

>n
Hallway
A guard paces back and forth through the hallway. To the north is the office.

You can see Officer here.

* * *

>wear guard uniform
You're already wearing that!

>kill yourself
Violence isn't the answer to this one.

>die
That's not a verb I recognise.

* * *

You awake in a dark room. You can't see anything at all. You can feel yourself sitting in a chair and you can make out a table in front of you. You have no idea where you are or what you were last doing. In fact, you don't remember anything about your past.

Inform 7
An Interactive Fiction by Cameron Kuwada
Release 1 / Serial number 131017 / Inform 7 build 6G60 (I6/v6.32 lib 6/12N) SD

interrogation room
It is very   in here. There is a bulletin board in the back. To the north is the hallway. A metal door to another room is to the east.

You can see Metal door and Shoes here.

>take all
Shoes: Taken.

>remove shoelaces
You remove shoelaces from shoes

* * *

I beg your pardon?

>combine shoelaces with thumbtack
You thread the shoelace onto the thumbtack, making a lockpick.

>unlock backdoor with lockpick
You unlock Backdoor.

* * *

>take guard uniform
Taken.

>wear shoes
You can't see any such thing.

>wear guard uniform
You put on Guard uniform.

>w
interrogation room
It is very bright in here. There is a bulletin board in the back. in the corner are shoes and a belt. to the north is the hallway. A metal door to another room is to the east.

You can see Backdoor here.

>n
Hallway
A guard paces back and forth through the hallway. To the north is the office.

You can see Officer here.

>talke to hallway
That's not a verb I recognise.

* * *

>take all
Shoes: Taken.

>remove shoelaces from shoes
You remove shoelaces from shoes

>x shoes
You can't see any such thing.

* * *

I beg your pardon?

>s
You can't go that way.

>combine shoelaces with thumbtack
You thread the shoelace onto the thumbtack, making a lockpick.

>use lockpick on door
That's not a verb I recognise.

>unlock door with lockpick
You can't see any such thing.

>unlock backdoor with lockpick
You unlock Backdoor.

* * *

>e
(first opening Backdoor)

surveillance room
This is where it seems someone was observing you while in the interrogation room. There is a surveillance system here. In the corner of the room is a white cabinet. There is a closet against the wall.

You can see Backdoor here.

>take all
There are none at all available!

>open closet
You open Closet, revealing Guard uniform and Pistol.

* * *

>take guard uniform
Taken.

>w
interrogation room
It is very bright in here. There is a bulletin board in the back. in the corner are shoes and a belt. to the north is the hallway. A metal door to another room is to the east.

You can see Backdoor here.

>n
Hallway
A guard paces back and forth through the hallway. To the north is the office.

You can see Officer here.

The guard sees you and shoots on sight.

    *** You have died ***

In that game you scored 0 out of a possible 0, in 12 turns.

Would you like to RESTART, RESTORE a saved game, QUIT or UNDO the last command?

>undo
interrogation room
[Previous turn undone.]

* * *

>wear guard uniform
You put on Guard uniform.

>n
Hallway
A guard paces back and forth through the hallway. To the north is the office.

You can see Officer here.

* * *

>take all
Shoes: Taken.

>undo
interrogation room
[Previous turn undone.]

* * *

>take all
Shoes: Taken.

>remove shoes
You're not wearing that.

>remove shoelaces
You remove shoelaces from shoes

>combine shoelaces with thumbtack
You can't see any such thing.

>x bulletin board
Some sort of notice is pressed against board. A large thumbtack is pressed into the board as well.

>take thumbtack
Taken.

>combine shoelaces with thumbtack
You thread the shoelace onto the thumbtack, making a make shift lockpick.

>unlock door with lockpick
You unlock Metal door.

>e
(first opening Metal door)

surveillance room
This is where it seems someone was observing you while in the interrogation room. There is a surveillance system monitoring various rooms. In the corner of the room is a white cabinet. There is a closet against the wall. To the west is lab.

You can see Metal door here.

>open closet
You open Closet, revealing Guard uniform and Pistol.

>take guard uniform
As you take the guard uniform, you can see a mirror. You look at your face and see a giant scar above your right eye and your untrimmed five o" clock shadow. Wait a second You are Jacob Smith!!!

* * *

You awake in a dark room. You can't see anything at all. You can feel yourself sitting in a chair and you can make out a table in front of you. You have no idea where you are or what you were last doing. In fact, you don't remember anything about your past.

Inform 7
An Interactive Fiction by Cameron Kuwada
Release 1 / Serial number 131017 / Inform 7 build 6G60 (I6/v6.32 lib 6/12N) SD

interrogation room
It is very   in here. There is a bulletin board in the back. To the north is the hallway. A metal door to another room is to the east.

You can see Metal door and Shoes here.

>take shoes
Taken.

>remove shoelaces
You're not wearing that.

>remove shoelaces from shoes
You can't see any such thing.

* * *

>take shoes
Taken.

>take thumbtack
Taken.

>remove shoelaces
You remove shoelaces from shoes

>combine shoelaces with thumbtack
You thread the shoelace onto the thumbtack

>x thumbtack
A thumbtack with shoelace tied around it.

* * *

>take shoes
Taken.

>remove shoelaces from shoes
You can't see any such thing.

* * *

>take shoes
Taken.

>x shoelaces
You can't see any such thing.

* * *

>take shoes
Taken.

>x bulletin board
Some sort of notice is pressed against board. A large thumbtack is pressed into the board as well.

>x desk
A dull, beige desk.

* * *

You awake in a dark room. You can't see anything at all. You can feel yourself sitting in a chair and you can make out a table in front of you. You have no idea where you are or what you were last doing. In fact, you don't remember anything about your past.

Inform 7
An Interactive Fiction by Cameron Kuwada
Release 1 / Serial number 131017 / Inform 7 build 6G60 (I6/v6.32 lib 6/12N) SD

interrogation room
It is very   in here. There is a bulletin board in the back. To the north is the hallway. A metal door to another room is to the east.

You can see Metal door and Shoes here.

>x metal door
You can't see any such thing.

>x backdoor
You see nothing special about Backdoor.

>x notice
There is a picture of a man with short grey hair and a five o'clock shadow. Above the picture, it says "Wanted: Jacob Smith."

>x mna
You can't see any such thing.

>x man
You can't see any such thing.

>x shoes
Elegant, black, leather shoes. They have laces.

>x laces
You can't see any such thing.

>x thumbtack
A long, sharp red thumbtack.

>take all
Notice: Taken.
Thumbtack: Taken.
Shoes: Taken.

>e
(first opening Backdoor)
It seems to be locked.

>w
You can't go that way.

>s
You can't go that way.

>n
Hallway
A guard paces back and forth through the hallway. To the north is the office.

You can see Officer here.

The guard sees you and shoots on sight.

    *** You have died ***

In that game you scored 0 out of a possible 0, in 9 turns.

Would you like to RESTART, RESTORE a saved game, QUIT or UNDO the last command?

>undo
interrogation room
[Previous turn undone.]

>l
interrogation room
It is very bright in here. There is a bulletin board in the back. in the corner are shoes and a belt. to the north is the hallway. A metal door to another room is to the east.

You can see Backdoor here.

>take backdoor
That's fixed in place.

>x bulletin board
Some sort of notice is pressed against board. A large thumbtack is pressed into the board as well.

>take belt
You can't see any such thing.

>turn off light
You can't see any such thing.

>x light
You can't see any such thing.

>x switch
You can't see any such thing.

>i
You are carrying:
  Shoes
  Thumbtack
  Notice

>put on shoes
Your feet ache really bad right now. One of the last things you want to do now is wear those uncomfortable things.

>read notice
There is a picture of a man with short grey hair and a five o'clock shadow. Above the picture, it says "Wanted: Jacob Smith."

>x me
As good-looking as ever.

>s
You can't go that way.

>w
You can't go that way.

>up
You can't go that way.

>down
You can't go that way.

>e
(first opening Backdoor)
It seems to be locked.

>open backdoor
It seems to be locked.

>unlock backdoor
What do you want to unlock Backdoor with?

>thumbtack
That doesn't seem to fit the lock.

>unlock backdoor with shoes
That doesn't seem to fit the lock.

>unlock backdoor with notice
That doesn't seem to fit the lock.

>i
You are carrying:
  Shoes
  Thumbtack
  Notice

>l
interrogation room
It is very bright in here. There is a bulletin board in the back. in the corner are shoes and a belt. to the north is the hallway. A metal door to another room is to the east.

You can see Backdoor here.

>x shoes
Elegant, black, leather shoes. They have laces.

>take laces
You can't see any such thing.

>x door
You can't see any such thing.

>x metal door
You can't see any such thing.

>n
Hallway
A guard paces back and forth through the hallway. To the north is the office.

You can see Officer here.

The guard sees you and shoots on sight.

    *** You have died ***

In that game you scored 0 out of a possible 0, in 28 turns.

Would you like to RESTART, RESTORE a saved game, QUIT or UNDO the last command?

>undo
interrogation room
[Previous turn undone.]

>e
(first opening Backdoor)
It seems to be locked.

>n
Hallway
A guard paces back and forth through the hallway. To the north is the office.

You can see Officer here.

The guard sees you and shoots on sight.

    *** You have died ***

In that game you scored 0 out of a possible 0, in 29 turns.

Would you like to RESTART, RESTORE a saved game, QUIT or UNDO the last command?

>undo
interrogation room
[Previous turn undone.]

* * *

>l
interrogation room
It is very bright in here. There is a bulletin board in the back. in the corner are shoes and a belt. to the north is the hallway. A metal door to another room is to the east.

You can see Backdoor here.

>x light
You can't see any such thing.

>x bright
You can't see any such thing.

>throw thumbtack
Dropped.

>take thumbtack
Taken.

>cover light
You can't see any such thing.

>take notics
You can't see any such thing.

>put notice on light
You can't see any such thing.

>unlock door
You can't see any such thing.

>unlock backdoor
What do you want to unlock Backdoor with?

* * *

>thumbtack
That doesn't seem to fit the lock.

>x backdoor
You see nothing special about Backdoor.

>x metal door
You can't see any such thing.

>x me
As good-looking as ever.

>x thumbtack
A long, sharp red thumbtack.

>attack door
You can't see any such thing.

>attack backdoor
Violence isn't the answer to this one.

>attack me
Violence isn't the answer to this one.

>stab door
That's not a verb I recognise.

>w
You can't go that way.

* * *

>s
You can't go that way.

>e
(first opening Backdoor)
It seems to be locked.

>put thumbtack on light
You can't see any such thing.

>kick door
That's not a verb I recognise.

>push door
You can't see any such thing.

>attack door
You can't see any such thing.

>jump
You jump on the spot, fruitlessly.

>sleep
You aren't feeling especially drowsy.

>i
You are carrying:
  Thumbtack
  Shoes
  Notice

>l
interrogation room
It is very bright in here. There is a bulletin board in the back. in the corner are shoes and a belt. to the north is the hallway. A metal door to another room is to the east.

You can see Backdoor here.

>x bulletin door
I only understood you as far as wanting to examine Bulletin board.

>x bulletin
Some sort of notice is pressed against board. A large thumbtack is pressed into the board as well.

>x board
Some sort of notice is pressed against board. A large thumbtack is pressed into the board as well.

>x notice
There is a picture of a man with short grey hair and a five o'clock shadow. Above the picture, it says "Wanted: Jacob Smith."

>x picture
You can't see any such thing.

>x me
As good-looking as ever.

>n
Hallway
A guard paces back and forth through the hallway. To the north is the office.

You can see Officer here.

The guard sees you and shoots on sight.

    *** You have died ***

In that game you scored 0 out of a possible 0, in 49 turns.

Would you like to RESTART, RESTORE a saved game, QUIT or UNDO the last command?

>s
Please give one of the answers above.

Would you like to RESTART, RESTORE a saved game, QUIT or UNDO the last command?

>undo
interrogation room
[Previous turn undone.]

>x hallway
You can't see any such thing.

>x officer
You can't see any such thing.

>throw thumbtack into hallway
You can't see any such thing.

>throw thumbtack at guard
You can't see any such thing.

>l
interrogation room
It is very bright in here. There is a bulletin board in the back. in the corner are shoes and a belt. to the north is the hallway. A metal door to another room is to the east.

You can see Backdoor here.

* * *

>x light
You can't see any such thing.

>x up
You see nothing unexpected in that direction.

>x wall
You can't see any such thing.

>x ceiling
You can't see any such thing.

>x floor
You can't see any such thing.

>remove shoelaces
You remove shoelaces from shoes

>combine thumbtack
(with Shoelaces)

* * *

>combine shoelaves with thumbtack
You can't see any such thing.

>unlock door with lockpick
You can't see any such thing.

>combine shoelaces with thumbtack
You thread the shoelace onto the thumbtack, making a lockpick.

>unlock backdoor with thumbtack
You can't see any such thing.

>unlock back door with lockpick
You can't see any such thing.

>i
You are carrying:
  a lockpick
  Notice

>unlock backdoor with lockpick
You unlock Backdoor.

* * *

>e
(first opening Backdoor)

surveillance room
This is where it seems someone was observing you while in the interrogation room. There is a surveillance system here. In the corner of the room is a white cabinet. There is a closet against the wall.

You can see Backdoor here.

>x surveillance system
You can't see any such thing.

>x white cabinet
A white cabinet. There's probably files inside.

>open cabinet
You open White Cabinet, revealing Files.

>take cabinet
That's hardly portable.

>take files
Taken.

>x closet
A large wooden closet. It looks pretty busted up.

>x wall
You can't see any such thing.

>take closet
That's hardly portable.

>open closet
You open Closet, revealing Guard uniform and Pistol.

* * *

>take all
Guard uniform: Taken.
Pistol: Taken.

>put on uniform
You put on Guard uniform.

>put on pistol
You can't wear that!

>w
interrogation room
It is very bright in here. There is a bulletin board in the back. in the corner are shoes and a belt. to the north is the hallway. A metal door to another room is to the east.

You can see Backdoor here.

* * *

>n
Hallway
A guard paces back and forth through the hallway. To the north is the office.

You can see Officer here.

>attack officer
Violence isn't the answer to this one.

>shoot officer
That's not a verb I recognise.

* * *

You awake in a dark room. You can't see anything at all. You can feel yourself sitting in a chair and you can make out a table in front of you. You have no idea where you are or what you were last doing. In fact, you don't remember anything about your past.

Inform 7
An Interactive Fiction by Cameron Kuwada
Release 1 / Serial number 131017 / Inform 7 build 6G60 (I6/v6.32 lib 6/12N) SD

interrogation room
It is very   in here. There is a bulletin board in the back. To the north is the hallway. A metal door to another room is to the east.

You can see Metal door and Shoes here.

>e
(first opening Backdoor)
It seems to be locked.

* * *

You awake in a dark room. You can't see anything at all. You can feel yourself sitting in a chair and you can make out a table in front of you. You have no idea where you are or what you were last doing. In fact, you don't remember anything about your past.

Inform 7
An Interactive Fiction by Cameron Kuwada
Release 1 / Serial number 131017 / Inform 7 build 6G60 (I6/v6.32 lib 6/12N) SD

interrogation room
It is very   in here. There is a bulletin board in the back. To the north is the hallway. A metal door to another room is to the east.

You can see Metal door and Shoes here.

>n
hallway
A guard paces around at the other end of the hallway. To the north is the office. to the west is a weapons room.

You can see White door and Officer here.

The guard sees you and shoots on sight.

    *** You have died ***

In that game you scored 0 out of a possible 0, in 1 turn.

Would you like to RESTART, RESTORE a saved game, QUIT or UNDO the last command?

>undo
interrogation room
[Previous turn undone.]

>x bulletin board
Some sort of notice is pressed against board. A large thumbtack is pressed into the board as well.

* * *

>take thumbtack
Taken.

>x notice
There is a picture of a man with short grey hair and a five o'clock shadow. He has a scar above his right eye. Above the picture, it says "Wanted: Jacob Smith."

>take shoes
Taken.

* * *

>combine shoelaces with thumbtack
You thread the shoelace onto the thumbtack, making a make shift lockpick.

>unlock metal door with lockpick
You unlock Metal door.

>e
(first opening Metal door)

surveillance room
This is where it seems someone was observing you while in the interrogation room. There is a surveillance system monitoring various rooms. In the corner of the room is a white cabinet. There is a closet against the wall. To the west is lab.

You can see Metal door here.

>e
Lab
A large monitor hangs on the wall. There is keyboard that you can use.

You can see Keyboard here.

>w
surveillance room
This is where it seems someone was observing you while in the interrogation room. There is a surveillance system monitoring various rooms. In the corner of the room is a white cabinet. There is a closet against the wall. To the west is lab.

You can see Metal door here.

>x computer
You see nothing special about Computer.

>open white cabinet
You open White Cabinet, revealing Files.

>take files
Taken.

>x files
A bunch of files. None are important except for one on in a red piece folder that says "Profile: Jacob Smith. Property of U.S. military."

>open closet
You open Closet, revealing Guard uniform and Pistol.

* * *

>x closet
A large wooden closet. It looks pretty busted up.

In Closet is Pistol.

>take pistol
Taken.

>w
interrogation room
It is very   in here. There is a bulletin board in the back. To the north is the hallway. A metal door to another room is to the east.

You can see Metal door and Notice here.

>n
hallway
A guard paces around at the other end of the hallway. To the north is the office. to the west is a weapons room.

You can see White door and Officer here.

The guard sees you and shoots on sight.

    *** You have died ***

In that game you scored 0 out of a possible 0, in 21 turns.

Would you like to RESTART, RESTORE a saved game, QUIT or UNDO the last command?

>undo
interrogation room
[Previous turn undone.]

>put on guard uniform
You put on Guard uniform.

>n
hallway
A guard paces around at the other end of the hallway. To the north is the office. to the west is a weapons room.

You can see White door and Officer here.

>w
(first opening White door)
It seems to be locked.

* * *

>n
hallway
A guard paces around at the other end of the hallway. To the north is the office. to the west is a weapons room.

You can see White door and Officer here.

>kill guard
Violence isn't the answer to this one.

>shoot guard
I didn't understand that sentence.

>kill guard with pistol
You shoot the guard and he falls down. His ID falls out of his pocket.

>take ID
You already have that.

>n
office
You can see White door here.

>x office
You can't see any such thing.

>e
Entrance
Two guards wait at the entrance.

>e
You can't go that way.

* * *

>n
hallway
A guard paces around at the other end of the hallway. To the north is the office. to the west is a weapons room.

You can see White door and Officer here.

The guard sees you and shoots on sight.

    *** You have died ***

In that game you scored 0 out of a possible 0, in 1 turn.

Would you like to RESTART, RESTORE a saved game, QUIT or UNDO the last command?

>s
interrogation room
It is very bright in here. There is a bulletin board in the back. in the corner are shoes and a belt. to the north is the hallway. A metal door to another room is to the east.

You can see Backdoor, Notice, Thumbtack and Shoes here.

>enter hallway
You can't see any such thing.

>m
That's not a verb I recognise.

>n
Hallway
A guard paces back and forth through the hallway. To the north is the office.

You can see Officer here.

* * *

>n
hallway
A guard paces around at the other end of the hallway. To the north is the office. to the west is a weapons room.

You can see White door and Officer here.

The guard sees you and shoots on sight.

    *** You have died ***

In that game you scored 0 out of a possible 0, in 1 turn.

Would you like to RESTART, RESTORE a saved game, QUIT or UNDO the last command?

>hallway
That's not a verb I recognise.